1111000000000000000000000000000000000000
0111000000000000000000000000000000000000
0111000000000000000000000000000000000000
0111000000000000000000000000000000000000
0111111111110000000000000000000000000000
0111111111110000000000000000000000000000
0111111111110000000000000000000000000000
0000000001110000000000000000000000000000
0000000001110000000000000000000000000000
0000000001110000000000000000000000000000
0000000001111000000000000000000000000000
0000000000111100000000000000000000000000
0000000000011111111111111111111111000000
0000000000001111111111111111111111000000
0000000000000111111111111111111111000000
0000000000000000000000000000000111000000
0000000000000000000000000000000111000000
0000000000000000000000000000000111000000
0000000000000000000000000000000111000000
0000000000000000000000000000000111000000
0000000000000000000000000000000111000000
0000000000000000000000000000000111000000
0000000000000000000000000000000111000000
0000000000000000000000000000000111000000
0000000000000000000000000000000111000000
0000000000000000000000000000000111000000
0000000000000000000000000000000111000000
0000000000000000000000000000000111000000
0000000000000000000000000000000111000000
0000000000000000000000000000000111000000
